53,53,53,53,53,53,53,53,53,53,53,53,53,53,53,53,53,53,53,53,53,53,53,53,53,53,53,53,53,53,53,53,53,53,53,53,53,53,53,53,53,53,53,53,53,53,53,53,53,53,53,53,53,53,53,53,53,53,53,53,53,53,53,53,53,53,53,53,53,53,53,53,53,53,53,53,53,53,53,53,53,53,53,53,53,53,53,53,53,53,53,53,53,53,53,53,53,53,53,53
53,53,53,53,53,53,53,53,53,53,53,53,53,53,53,53,53,53,53,53,53,53,53,53,53,53,53,53,53,53,53,53,53,53,53,53,53,53,53,53,53,53,53,53,53,53,53,53,53,53,53,53,53,53,53,53,53,53,53,53,53,53,53,53,53,53,53,53,53,53,53,53,53,53,53,53,53,53,53,53,53,53,53,53,53,53,53,53,53,53,53,53,53,53,53,53,53,53,53,53
53,53,53,53,53,53,53,53,53,53,53,53,53,53,53,53,53,53,53,53,53,53,53,53,53,53,53,53,53,53,53,53,53,53,53,53,53,53,53,53,53,53,53,53,53,53,53,53,53,53,53,53,53,53,53,53,53,53,53,53,53,53,53,53,53,53,53,53,53,53,53,53,53,53,53,53,53,53,53,53,53,53,53,53,53,53,53,53,53,53,53,53,53,53,53,53,53,53,53,53
53,53,53,53,53,53,53,53,53,53,53,53,53,53,53,53,53,53,53,53,53,53,53,53,53,53,53,53,53,53,53,53,53,53,53,53,53,53,53,53,53,53,53,53,53,53,53,53,53,53,53,53,53,53,53,53,53,53,53,53,53,53,53,53,53,53,53,53,53,53,53,53,53,53,53,53,53,53,53,53,53,53,53,53,53,53,53,53,53,53,53,53,53,53,53,53,53,53,53,53
53,53,53,53,53,53,53,53,53,53,53,53,53,53,53,53,53,53,53,53,53,53,53,53,53,53,53,53,53,53,53,53,53,53,53,53,53,53,53,53,53,53,53,53,53,53,53,53,53,53,53,53,53,53,53,53,53,53,53,53,53,53,53,53,53,53,53,53,53,53,53,53,53,53,53,53,53,53,53,53,53,53,53,53,53,53,53,53,53,53,53,53,53,53,53,53,53,53,53,53
53,53,53,53,53,53,53,53,53,53,53,53,53,53,53,53,53,53,53,53,53,53,53,53,53,53,53,53,53,53,53,53,53,53,53,53,53,53,53,53,53,53,53,53,53,53,53,53,53,53,53,53,53,53,53,53,53,53,53,53,53,53,53,53,53,53,53,53,53,53,53,53,53,53,53,53,53,53,53,53,53,53,53,53,53,53,53,53,53,53,53,53,53,53,53,53,53,53,53,53
53,53,53,53,53,53,53,53,53,53,53,53,53,53,53,53,53,53,53,53,53,53,53,53,53,53,53,53,53,53,53,53,53,53,53,53,53,53,53,53,53,53,53,53,53,53,53,53,53,53,53,53,53,53,53,53,53,53,53,53,53,53,53,53,53,53,53,53,53,53,53,53,53,53,53,53,53,53,53,53,53,53,53,53,53,53,53,53,53,53,53,53,53,53,53,53,53,53,53,53
53,53,53,53,53,53,53,53,53,53,53,53,53,53,53,53,53,53,53,53,53,53,53,53,53,53,53,53,53,53,53,53,53,53,53,53,53,53,53,53,53,53,53,53,53,53,53,53,53,53,53,53,53,53,53,53,53,53,53,53,53,53,53,53,53,53,53,53,53,53,53,53,53,53,53,53,53,53,53,53,53,53,53,53,53,53,53,53,53,53,53,53,53,53,53,53,53,53,53,53
53,53,53,53,53,53,53,53,53,53,53,53,53,53,53,53,53,53,53,53,53,53,53,53,53,53,53,53,53,53,53,53,53,53,53,53,53,53,53,53,53,53,53,53,53,53,53,53,53,53,53,53,53,53,53,53,53,53,53,53,53,53,53,53,53,53,53,53,53,53,53,53,53,53,53,53,53,53,53,53,53,53,53,53,53,53,53,53,53,53,53,53,53,53,53,53,53,53,53,53
53,53,53,53,53,53,53,53,53,53,53,53,53,53,53,53,53,53,53,53,53,53,53,53,53,53,53,53,53,53,53,53,53,53,53,53,53,53,53,53,53,53,53,53,53,53,53,53,53,53,53,53,53,53,53,53,53,53,53,53,53,53,53,53,53,53,53,53,53,53,53,53,53,53,53,53,53,53,53,53,53,53,53,53,53,53,53,53,53,53,53,53,53,53,53,53,53,53,53,53
53,53,53,53,53,53,53,53,53,53,53,53,53,53,53,53,53,53,53,53,53,53,53,53,53,53,53,53,53,53,53,53,62,55,55,55,55,55,63,53,53,53,53,53,53,53,53,53,53,53,53,53,53,53,53,53,53,53,53,53,53,53,53,53,53,53,53,62,55,55,55,55,55,55,55,55,55,55,55,63,53,53,53,53,53,53,53,53,53,53,53,53,53,53,53,53,53,53,53,53
53,53,53,53,53,53,53,53,53,53,53,53,53,53,53,53,53,53,53,53,53,53,53,53,53,53,53,53,53,53,62,55,61,0,0,0,0,0,60,55,55,55,55,63,53,53,53,53,53,53,53,53,53,53,53,53,53,53,53,53,53,53,53,62,55,55,55,61,0,0,0,0,0,0,0,0,0,0,0,60,55,55,63,53,53,53,53,53,53,53,53,53,53,53,53,53,53,53,53,53
53,53,53,53,53,53,53,53,53,53,53,53,53,53,53,53,53,53,53,53,62,55,55,55,55,55,55,55,55,55,61,0,0,0,0,0,0,0,0,0,0,0,0,60,63,62,55,55,55,63,53,53,53,53,53,53,53,53,62,55,55,55,55,61,0,0,0,0,0,0,0,0,0,0,0,0,0,0,0,0,0,0,60,55,63,53,53,53,53,53,53,53,53,53,53,53,53,53,53,53
53,53,53,53,53,53,53,53,53,53,53,53,53,53,53,53,53,53,53,62,61,0,0,0,0,0,0,0,0,0,0,0,0,0,0,0,0,0,0,0,0,0,0,0,56,57,0,0,0,60,55,55,55,55,55,55,55,55,61,0,0,0,0,0,0,0,0,0,0,0,0,0,0,0,0,0,0,0,0,0,0,0,0,0,60,63,53,53,53,53,53,53,53,53,53,53,53,53,53,53
53,53,53,53,53,53,53,53,53,53,53,53,53,53,53,53,53,53,62,61,0,0,0,0,0,0,0,0,0,0,0,0,0,0,0,0,0,0,0,0,0,0,0,0,56,57,0,0,0,0,0,0,0,0,0,0,0,0,0,0,0,0,0,0,0,0,0,0,0,0,0,0,0,0,0,0,0,0,0,0,0,0,0,0,0,60,63,53,53,53,53,53,53,53,53,53,53,53,53,53
53,53,53,53,53,53,53,53,53,53,53,53,53,53,53,53,53,62,61,0,0,0,0,0,0,0,0,0,0,0,0,0,0,0,0,0,0,21,0,0,0,0,0,0,56,57,0,0,0,0,0,0,0,0,0,0,0,0,0,0,0,0,0,0,0,0,0,0,0,0,79,0,0,0,0,0,0,0,0,0,0,0,0,0,0,0,56,53,53,53,53,53,53,53,53,53,53,53,53,53
53,53,53,53,53,53,53,53,53,53,53,53,53,53,53,62,55,61,0,0,0,0,0,0,0,0,0,0,0,0,0,0,0,0,0,0,0,20,0,0,0,0,0,0,56,57,0,0,0,0,0,0,0,71,68,68,72,0,0,0,79,0,0,13,0,71,68,68,68,68,68,68,68,0,0,0,79,0,0,0,0,0,0,0,0,0,60,63,53,53,53,53,53,53,53,53,53,53,53,53
53,53,53,53,53,53,53,53,53,53,53,53,53,53,62,61,0,0,0,0,0,0,0,0,0,0,0,0,0,0,0,0,0,0,0,0,0,20,0,0,0,0,0,0,56,57,0,0,0,0,0,0,0,78,66,66,76,68,68,68,68,68,68,68,68,78,66,66,66,66,66,66,66,76,68,0,0,0,0,0,0,0,0,0,0,0,0,56,53,53,53,53,53,53,53,53,53,53,53,53
53,53,53,53,53,53,53,53,53,53,53,53,53,62,61,0,0,0,0,0,0,0,0,0,0,0,0,0,0,0,0,0,0,0,0,0,0,20,0,0,0,0,0,58,65,57,0,0,0,0,0,0,0,66,66,66,66,66,66,66,66,66,66,66,66,66,66,66,66,66,66,66,66,66,66,68,0,0,0,0,0,0,0,0,0,0,0,56,53,53,53,53,53,53,53,53,53,53,53,53
53,53,53,53,53,53,53,53,53,53,53,53,62,61,0,0,0,0,0,0,0,18,17,17,17,17,17,17,17,17,17,17,17,17,17,17,17,31,0,0,0,0,0,56,62,61,0,0,0,0,0,0,15,66,66,66,66,66,66,66,66,66,66,66,66,66,66,66,66,66,66,66,66,66,66,66,69,0,0,0,0,0,0,0,0,0,0,56,53,53,53,53,53,53,53,53,53,53,53,53
53,53,53,53,53,53,53,53,53,53,53,53,57,0,0,0,0,0,0,0,0,0,0,71,68,68,68,68,0,0,0,0,0,0,0,0,0,20,13,0,0,0,0,56,57,0,0,0,0,0,0,0,0,77,66,66,66,66,66,66,66,66,66,66,66,66,66,66,66,66,66,66,66,66,66,66,69,0,0,79,0,0,0,0,0,0,0,56,53,53,53,53,53,53,53,53,53,53,53,53
53,53,53,53,53,53,53,53,53,53,53,62,61,0,0,0,0,0,0,0,0,0,70,66,66,66,66,66,76,72,0,0,0,0,0,0,0,20,0,0,0,0,0,56,57,0,0,0,0,0,0,0,0,73,66,66,66,66,66,66,66,66,66,66,66,66,66,66,66,66,66,66,66,66,66,74,0,0,79,0,0,0,0,0,0,0,0,56,53,53,53,53,53,53,53,53,53,53,53,53
53,53,53,53,53,53,53,53,53,53,53,57,0,0,0,0,0,0,0,0,0,0,70,66,66,66,66,66,66,69,0,0,0,0,0,0,0,20,0,0,0,0,0,56,57,0,0,0,0,0,0,0,14,0,66,66,66,66,66,66,66,66,66,66,66,66,66,66,66,66,66,66,66,66,74,16,0,0,0,0,0,0,0,0,0,0,0,56,53,53,53,53,53,53,53,53,53,53,53,53
53,53,53,53,53,53,53,53,53,53,53,57,0,0,0,0,0,0,0,0,0,0,70,66,66,66,66,66,66,76,72,0,0,0,0,0,0,20,0,0,0,0,0,56,57,0,0,0,0,0,0,0,0,0,73,66,66,66,66,66,66,66,66,66,66,66,66,66,66,66,66,66,74,0,0,0,0,0,0,0,0,0,0,0,0,0,0,56,53,53,53,53,53,53,53,53,53,53,53,53
53,53,53,53,53,53,53,53,53,53,53,57,0,0,0,0,0,0,0,0,79,0,78,66,66,66,66,66,66,66,69,0,0,0,0,0,0,20,0,0,0,0,0,56,57,0,0,12,0,0,0,0,0,0,0,73,77,66,66,66,66,66,66,66,66,66,66,66,66,74,14,0,0,0,0,0,0,0,0,0,0,0,0,0,0,0,58,65,53,53,53,53,53,53,53,53,53,53,53,53
53,53,53,53,53,53,53,53,53,53,53,57,0,0,0,0,0,0,0,0,0,70,66,66,66,66,66,66,66,66,69,14,79,0,0,0,0,20,0,0,0,0,0,56,57,0,0,0,0,0,0,0,0,0,0,0,0,14,0,0,0,0,0,0,15,0,0,0,0,0,0,0,0,12,0,0,0,0,0,0,0,0,0,0,0,0,56,53,53,53,53,53,53,53,53,53,53,53,53,53
53,53,53,53,53,53,53,53,53,53,62,61,0,0,11,0,0,0,0,79,0,78,66,66,66,66,66,66,66,66,69,0,0,0,0,0,0,20,0,0,0,0,0,56,57,0,0,0,0,0,0,0,0,0,0,0,0,0,0,79,0,79,0,0,0,0,0,0,0,0,0,0,0,0,0,0,0,0,0,0,0,0,0,0,0,0,56,53,53,53,53,53,53,53,53,53,53,53,53,53
53,53,53,53,53,53,53,53,53,53,57,0,0,0,0,0,79,0,0,0,78,66,66,66,66,66,66,66,66,69,0,0,0,0,0,0,0,20,0,0,0,0,0,56,57,0,0,0,0,79,0,0,11,0,0,0,0,0,0,0,0,0,0,0,0,0,0,0,79,0,0,0,0,0,0,0,0,0,0,0,0,0,0,0,0,0,56,53,53,53,53,53,53,53,53,53,53,53,53,53
53,53,53,53,53,53,53,53,53,53,57,0,0,0,0,0,0,0,0,70,66,66,66,66,66,66,66,66,66,69,0,14,0,0,0,0,0,34,0,0,0,0,0,56,57,0,10,0,0,0,0,0,0,0,0,0,0,0,0,0,0,0,0,0,0,0,0,0,0,0,79,0,0,0,0,0,0,0,0,0,0,0,0,0,0,58,65,53,53,53,53,53,53,53,53,53,53,53,53,53
53,53,53,53,53,53,53,53,53,53,57,0,0,0,0,0,0,0,0,78,66,66,66,66,66,66,66,66,69,0,0,0,79,0,0,0,0,45,36,36,36,36,36,48,49,33,17,17,17,17,17,17,17,17,17,17,17,17,17,17,17,17,17,17,17,17,17,17,17,28,17,17,17,17,17,17,17,19,0,0,0,0,0,0,0,56,53,53,53,53,53,53,53,53,53,53,53,53,53,53
53,53,53,53,53,53,53,53,53,53,57,0,0,0,0,0,0,71,78,66,66,66,66,66,66,66,66,66,69,16,0,0,0,0,0,0,0,37,0,0,10,0,0,51,52,0,0,0,0,0,0,0,0,0,0,71,68,68,68,68,68,68,72,0,0,0,0,0,11,20,0,0,0,0,0,0,0,0,0,0,0,0,0,0,58,65,53,53,53,53,53,53,53,53,53,53,53,53,53,53
53,53,53,53,53,53,53,53,53,53,64,59,0,0,0,0,0,70,66,66,66,66,66,66,66,66,66,66,69,0,0,79,0,0,0,0,0,37,0,0,0,0,0,56,57,0,0,0,0,0,0,71,68,68,68,78,66,66,66,66,66,66,76,72,0,0,0,0,0,20,0,0,0,0,0,0,0,0,0,0,0,0,0,58,65,53,53,53,53,53,53,53,53,53,53,53,53,53,53,53
53,53,53,53,53,53,53,53,53,53,53,57,0,0,0,0,0,70,66,66,66,66,66,66,66,66,66,66,69,0,15,0,0,0,0,0,0,37,0,0,0,79,0,56,57,0,0,0,0,0,0,70,66,66,66,66,66,66,66,66,66,66,66,66,72,16,0,0,0,20,0,0,0,0,0,0,0,0,79,0,0,0,0,56,53,53,53,53,53,53,53,53,53,53,53,53,53,53,53,53
53,53,53,53,53,53,53,53,53,53,53,57,0,0,0,0,0,70,66,66,66,66,66,66,66,66,66,66,69,0,0,0,0,0,0,0,0,37,0,0,0,0,0,56,57,0,0,0,0,15,0,70,66,66,66,66,66,66,66,66,66,66,66,66,66,72,0,0,0,20,0,0,0,0,0,0,71,72,0,0,0,0,0,56,53,53,53,53,53,53,53,53,53,53,53,53,53,53,53,53
53,53,53,53,53,53,53,53,53,53,53,57,0,0,0,0,0,70,66,66,66,66,66,66,66,66,66,66,76,68,0,0,0,0,0,0,79,37,0,0,0,0,0,56,57,0,79,0,0,0,0,70,66,66,66,66,66,66,66,66,66,66,66,66,66,76,72,0,0,20,0,0,0,0,0,78,66,66,76,72,0,13,0,56,53,53,53,53,53,53,53,53,53,53,53,53,53,53,53,53
53,53,53,53,53,53,53,53,53,53,53,57,0,0,0,0,0,70,66,66,66,66,66,66,66,66,66,66,66,66,76,0,16,0,0,0,0,37,0,0,0,79,0,56,57,0,0,0,0,0,0,0,77,66,66,66,66,66,66,66,66,66,66,66,66,66,69,0,0,20,0,0,0,0,70,66,66,66,66,69,0,0,0,56,53,53,53,53,53,53,53,53,53,53,53,53,53,53,53,53
53,53,53,53,53,53,53,53,53,53,53,57,0,0,0,0,79,70,66,66,66,66,66,66,66,66,66,66,66,66,66,76,68,0,0,0,0,37,0,0,0,0,0,56,64,59,0,0,79,0,0,0,0,77,66,66,66,66,66,66,66,66,66,66,66,66,69,79,0,20,0,0,15,0,78,66,66,66,66,76,72,0,0,56,53,53,53,53,53,53,53,53,53,53,53,53,53,53,53,53
53,53,53,53,53,53,53,53,53,53,53,57,0,0,0,0,0,70,66,66,66,66,66,66,66,66,66,66,66,66,66,66,66,76,0,0,0,37,0,0,0,0,0,56,53,64,59,0,0,79,0,0,0,16,67,66,66,66,66,66,66,66,66,66,66,66,69,0,0,20,0,0,0,70,66,66,66,66,66,66,69,0,0,56,53,53,53,53,53,53,53,53,53,53,53,53,53,53,53,53
53,53,53,53,53,53,53,53,53,53,53,57,0,0,0,0,0,70,66,66,66,66,66,66,66,66,66,66,66,66,66,66,66,66,76,68,0,37,0,0,0,79,0,60,63,53,64,59,0,0,0,0,0,0,70,66,66,66,66,66,66,66,66,66,66,66,69,0,0,20,0,79,0,78,66,66,66,66,66,66,69,79,0,56,53,53,53,53,53,53,53,53,53,53,53,53,53,53,53,53
53,53,53,53,53,53,53,53,53,53,53,57,0,0,0,0,0,70,66,66,66,66,66,66,66,66,66,66,66,66,66,66,66,66,66,66,69,37,0,0,0,0,0,0,60,63,53,64,59,0,0,0,0,0,70,66,66,66,66,66,66,66,66,66,66,66,69,14,0,20,0,0,70,66,66,66,66,66,66,66,69,0,0,56,53,53,53,53,53,53,53,53,53,53,53,53,53,53,53,53
53,53,53,53,53,53,53,53,53,53,53,57,0,0,0,0,0,73,66,66,66,66,66,66,66,66,66,66,66,66,66,66,66,66,66,66,69,37,0,0,0,0,0,0,0,60,63,53,64,54,59,0,0,0,0,67,66,66,66,66,66,66,66,66,66,66,69,0,0,20,0,14,70,66,66,66,66,66,66,66,69,0,0,56,53,53,53,53,53,53,53,53,53,53,53,53,53,53,53,53
53,53,53,53,53,53,53,53,53,53,53,57,0,0,0,0,0,79,73,66,66,66,66,66,66,66,66,66,66,66,66,66,66,66,66,66,69,37,0,0,0,0,0,0,0,0,60,55,63,53,64,59,0,0,0,70,66,66,66,66,66,66,66,66,66,66,69,0,0,20,0,0,78,66,66,66,66,66,66,66,69,0,0,60,63,53,53,53,53,53,53,53,53,53,53,53,53,53,53,53
53,53,53,53,53,53,53,53,53,53,53,57,0,0,0,0,0,0,0,66,66,66,66,66,66,66,66,66,66,66,66,66,66,66,66,67,74,37,0,0,0,0,0,0,0,0,0,0,60,55,63,64,59,0,0,70,66,66,66,66,66,66,66,66,66,66,74,0,79,20,0,70,66,66,66,66,66,66,66,66,69,0,0,0,60,63,53,53,53,53,53,53,53,53,53,53,53,53,53,53
53,53,53,53,53,53,53,53,53,53,53,57,0,0,0,0,0,0,79,73,66,66,66,66,66,66,66,66,66,66,66,66,66,66,66,69,0,37,0,0,0,0,0,0,0,0,0,0,0,0,60,63,64,59,0,0,77,66,66,66,66,66,66,67,67,74,0,0,0,20,79,70,66,66,66,66,66,66,66,66,69,79,0,0,0,60,63,53,53,53,53,53,53,53,53,53,53,53,53,53
53,53,53,53,53,53,53,53,53,53,53,57,0,0,0,0,0,0,0,70,66,66,66,66,66,66,66,66,66,66,66,66,66,66,66,69,0,37,0,0,0,0,0,0,0,0,0,0,0,0,0,60,63,64,59,0,0,67,67,67,67,67,74,16,0,0,0,0,12,20,0,70,66,66,66,66,66,66,66,66,69,0,0,0,0,0,60,63,53,53,53,53,53,53,53,53,53,53,53,53
53,53,53,53,53,53,53,53,53,53,53,57,0,0,0,0,0,0,0,70,66,66,66,66,66,66,66,66,66,66,66,66,66,66,67,74,0,37,0,0,0,0,0,0,0,0,0,0,0,0,0,0,60,63,57,0,0,0,15,0,0,0,0,0,0,79,0,0,0,20,0,73,66,66,66,66,66,66,66,66,76,0,0,0,0,0,0,60,63,53,53,53,53,53,53,53,53,53,53,53
53,53,53,53,53,53,53,53,53,53,53,57,0,0,0,0,0,0,0,70,66,66,66,66,66,66,66,66,66,66,66,66,67,74,16,0,0,37,0,0,12,0,0,0,0,11,0,0,0,0,0,0,0,56,57,0,0,79,0,0,0,79,0,0,0,0,0,0,0,20,0,0,73,66,66,66,66,66,66,66,66,69,0,0,10,0,0,0,56,53,53,53,53,53,53,53,53,53,53,53
53,53,53,53,53,53,53,53,53,53,53,64,59,0,0,0,0,0,0,70,66,66,66,66,66,66,66,66,66,66,67,67,0,0,0,0,0,37,0,0,0,79,0,0,0,0,0,0,0,0,0,0,79,56,57,0,0,0,0,0,0,0,0,0,0,0,0,0,0,20,0,0,0,66,66,66,66,66,66,66,66,69,79,0,0,0,0,0,60,63,53,53,53,53,53,53,53,53,53,53
53,53,53,53,53,53,53,53,53,53,53,53,57,0,0,0,0,0,0,73,66,66,66,66,66,66,66,66,66,74,0,0,0,0,0,0,0,40,36,36,43,36,36,36,36,36,36,36,36,36,36,36,36,48,49,33,17,17,17,17,17,17,17,17,17,17,17,17,17,31,0,0,0,73,66,66,66,66,66,66,66,69,0,0,0,0,0,0,0,56,53,53,53,53,53,53,53,53,53,53
53,53,53,53,53,53,53,53,53,53,53,53,57,0,0,0,0,79,0,0,73,66,66,66,66,66,67,67,74,0,14,0,0,0,0,0,0,0,10,79,37,0,0,0,0,0,0,0,0,0,0,0,79,51,52,1,1,1,1,1,1,1,1,1,1,1,1,1,0,20,0,0,16,70,66,66,66,66,66,66,66,69,0,0,0,0,0,0,0,56,53,53,53,53,53,53,53,53,53,53
53,53,53,53,53,53,53,53,53,53,53,53,57,0,0,0,0,0,0,0,0,73,67,67,67,74,16,0,0,0,0,0,0,0,0,0,0,0,0,0,37,0,0,0,0,0,0,0,10,0,0,0,0,56,57,1,1,1,1,3,3,1,1,1,1,1,1,1,0,20,0,0,0,70,66,66,66,66,66,66,66,69,0,0,0,0,0,0,0,56,53,53,53,53,53,53,53,53,53,53
53,53,53,53,53,53,53,53,53,53,53,53,64,59,0,0,0,0,0,0,0,0,0,0,0,0,0,0,0,0,0,0,0,0,0,0,0,0,0,0,37,0,0,0,0,0,0,0,0,0,0,0,58,65,57,1,3,5,5,5,5,5,5,5,5,1,1,1,10,20,0,79,0,70,66,66,66,66,66,66,66,69,0,79,0,0,0,0,0,56,53,53,53,53,53,53,53,53,53,53
53,53,53,53,53,53,53,53,53,53,53,53,53,57,0,0,0,13,0,0,0,0,0,0,0,0,0,0,0,0,0,0,0,0,0,0,0,0,0,0,37,0,0,0,0,0,0,0,0,0,0,58,65,62,61,1,1,4,5,5,12,10,9,7,4,5,5,1,0,20,0,0,0,70,66,66,66,66,66,66,66,69,79,0,0,13,0,0,0,56,53,53,53,53,53,53,53,53,53,53
53,53,53,53,53,53,53,53,53,53,53,53,53,57,0,0,0,0,0,0,81,82,82,82,82,82,82,82,82,82,82,82,82,82,82,82,82,82,83,0,37,0,0,0,0,0,0,0,0,0,0,56,53,57,1,1,1,2,5,5,5,5,5,10,5,4,12,1,0,20,0,0,0,73,66,66,66,66,66,66,66,69,0,0,0,0,0,0,0,56,53,53,53,53,53,53,53,53,53,53
53,53,53,53,53,53,53,53,53,53,53,53,53,57,0,0,0,0,0,0,81,82,82,82,82,82,82,82,82,82,82,82,82,82,82,82,82,82,83,0,37,0,0,0,0,13,0,0,0,0,0,56,53,57,1,3,1,1,7,12,7,11,5,5,5,5,5,1,0,20,0,0,79,0,67,66,66,66,66,66,66,69,79,0,0,0,0,0,0,56,53,53,53,53,53,53,53,53,53,53
53,53,53,53,53,53,53,53,53,53,53,53,53,57,0,0,0,0,0,0,81,82,82,82,82,82,82,82,82,82,82,82,82,82,82,82,82,82,83,0,37,0,0,0,0,0,0,0,0,0,0,56,53,57,1,2,3,1,5,7,5,5,3,13,4,5,3,1,0,20,0,0,0,0,70,66,66,66,66,66,66,69,0,0,79,0,0,0,0,56,53,53,53,53,53,53,53,53,53,53
53,53,53,53,53,53,53,53,53,53,53,53,53,57,0,0,0,0,0,0,81,82,82,82,82,82,82,82,82,82,82,82,82,82,82,82,82,82,83,0,37,0,0,0,0,0,0,0,0,0,58,65,53,57,1,1,1,4,4,5,5,5,7,5,5,5,5,1,0,20,0,0,0,0,70,66,66,66,66,66,66,69,0,0,0,0,0,0,0,56,53,53,53,53,53,53,53,53,53,53
53,53,53,53,53,53,53,53,53,53,53,53,53,57,0,0,0,0,0,0,0,0,0,0,0,0,0,0,0,0,0,0,0,0,0,0,0,0,0,0,37,0,0,0,0,0,0,0,0,58,65,53,53,64,59,1,1,1,1,3,1,1,7,5,7,10,11,1,0,20,0,0,0,79,0,77,66,66,66,66,66,69,0,1,1,1,1,1,1,56,53,53,53,53,53,53,53,53,53,53
53,53,53,53,53,53,53,53,53,53,53,53,53,57,0,0,0,0,17,17,17,17,17,17,32,36,36,36,36,43,36,36,36,36,36,36,36,36,36,36,41,0,0,0,0,0,0,0,58,65,53,53,53,53,64,54,59,1,1,1,1,3,1,5,5,5,5,1,0,20,0,13,0,14,0,0,77,66,66,66,74,0,0,1,1,4,1,1,1,56,53,53,53,53,53,53,53,53,53,53
53,53,53,53,53,53,53,53,53,53,53,53,53,57,0,0,0,0,0,0,0,0,0,0,0,0,0,0,0,37,0,0,0,0,0,0,0,0,0,0,0,0,0,0,0,0,0,58,65,53,53,53,53,53,53,53,64,54,54,59,1,1,1,7,10,5,5,1,0,22,0,0,0,0,0,15,0,67,67,74,0,14,3,1,1,4,1,4,1,56,53,53,53,53,53,53,53,53,53,53
53,53,53,53,53,53,53,53,53,53,53,53,53,64,59,0,0,0,0,0,85,86,86,86,86,86,86,87,0,37,0,89,90,90,90,90,90,90,91,0,0,0,0,0,0,0,58,65,53,53,53,53,53,53,53,53,53,53,53,64,59,3,1,1,5,5,7,1,1,1,0,0,79,0,0,0,0,0,0,0,0,3,3,3,1,3,1,3,1,56,53,53,53,53,53,53,53,53,53,53
53,53,53,53,53,53,53,53,53,53,53,53,53,53,57,0,0,0,0,0,85,86,86,86,86,86,86,87,0,37,0,89,90,90,90,90,90,90,91,0,0,0,0,79,0,0,56,53,53,53,53,53,53,53,53,53,53,53,53,53,64,59,1,1,5,13,5,1,1,2,1,1,2,1,1,1,1,2,1,1,5,3,5,3,5,13,1,1,1,56,53,53,53,53,53,53,53,53,53,53
53,53,53,53,53,53,53,53,53,53,53,53,53,53,57,0,0,0,0,0,85,86,86,86,86,86,86,87,0,37,0,89,90,90,90,90,90,90,91,0,0,0,0,0,0,0,56,53,53,53,53,53,53,53,53,53,53,53,53,53,53,64,59,1,5,4,5,5,3,12,2,1,2,1,2,1,2,1,2,1,1,5,4,11,5,3,1,1,3,56,53,53,53,53,53,53,53,53,53,53
53,53,53,53,53,53,53,53,53,53,53,53,53,53,57,0,0,0,0,0,85,86,86,86,86,86,86,87,0,37,0,89,90,90,90,90,90,90,91,0,0,0,0,0,0,0,56,53,53,53,53,53,53,53,53,53,53,53,53,53,53,53,64,59,1,1,1,4,3,5,5,5,5,5,5,11,4,4,2,2,5,10,4,5,5,5,1,1,58,65,53,53,53,53,53,53,53,53,53,53
53,53,53,53,53,53,53,53,53,53,53,53,53,53,57,0,0,11,0,0,85,86,86,86,86,86,86,87,0,37,0,89,90,90,90,90,90,90,91,0,0,0,0,0,0,0,56,53,53,53,53,53,53,53,53,53,53,53,53,53,53,53,53,57,1,1,2,1,4,4,3,4,4,13,5,7,5,5,5,5,10,10,5,5,3,5,1,1,56,53,53,53,53,53,53,53,53,53,53,53
53,53,53,53,53,53,53,53,53,53,53,53,53,53,57,0,0,0,0,0,85,86,86,86,86,86,86,87,0,37,0,89,90,90,90,90,90,90,91,0,0,0,0,0,0,0,56,53,53,53,53,53,53,53,53,53,53,53,53,53,53,53,53,64,59,1,1,1,1,5,5,3,5,3,5,5,5,5,5,12,5,5,9,5,5,3,1,1,56,53,53,53,53,53,53,53,53,53,53,53
53,53,53,53,53,53,53,53,53,53,53,53,53,62,61,0,0,0,0,0,85,86,86,86,86,86,86,87,0,37,0,89,90,90,90,90,90,90,91,0,0,0,0,0,79,0,56,53,53,53,53,53,53,53,53,53,53,53,53,53,53,53,53,53,57,1,2,2,1,3,3,5,5,5,5,58,54,54,54,54,59,5,5,5,5,5,1,1,56,53,53,53,53,53,53,53,53,53,53,53
53,53,53,53,53,53,53,53,53,53,53,53,53,57,0,0,0,0,0,0,85,86,86,86,86,86,86,87,0,37,0,89,90,90,90,90,90,90,91,0,0,0,0,0,0,0,56,53,53,53,53,53,53,53,53,53,53,53,53,53,53,53,53,53,64,59,1,1,1,5,3,7,5,5,58,65,53,53,53,53,64,59,5,5,5,1,1,1,56,53,53,53,53,53,53,53,53,53,53,53
53,53,53,53,53,53,53,53,53,53,53,53,53,57,0,0,0,0,0,0,85,86,86,86,86,86,86,87,0,37,0,89,90,90,90,90,90,90,91,0,0,0,0,12,0,0,56,53,53,53,53,53,53,53,53,53,53,53,53,53,53,53,53,53,53,57,1,1,3,3,3,2,5,5,56,53,53,53,53,53,53,57,5,5,3,1,1,3,56,53,53,53,53,53,53,53,53,53,53,53
53,53,53,53,53,53,53,53,53,53,53,53,53,57,0,0,0,0,0,0,85,86,86,86,86,86,86,87,0,37,0,89,90,90,90,90,90,90,91,0,0,0,0,0,0,0,60,63,53,53,53,53,53,53,53,53,53,53,53,53,53,53,53,53,53,64,59,1,1,5,5,5,12,5,56,53,53,53,53,53,53,57,5,5,3,5,1,1,56,53,53,53,53,53,53,53,53,53,53,53
53,53,53,53,53,53,53,53,53,53,53,53,53,57,0,0,0,0,0,0,85,86,86,86,86,86,86,87,0,37,0,89,90,90,90,90,90,90,91,0,0,0,0,0,0,0,0,60,63,53,53,53,53,53,53,53,53,53,53,53,53,53,53,53,53,53,57,3,1,5,5,5,5,5,60,55,63,53,53,53,62,61,5,3,10,5,1,1,56,53,53,53,53,53,53,53,53,53,53,53
53,53,53,53,53,53,53,53,53,53,53,53,53,57,0,0,0,0,0,0,85,86,86,86,86,86,86,87,0,37,0,89,90,90,90,90,90,90,91,0,0,0,0,0,0,0,0,0,60,55,63,53,53,53,53,53,53,53,53,53,53,53,53,53,53,53,57,1,1,5,5,5,9,5,5,79,60,55,55,55,61,5,5,5,5,5,1,1,56,53,53,53,53,53,53,53,53,53,53,53
53,53,53,53,53,53,53,53,53,53,53,53,53,57,0,0,0,0,0,0,85,86,86,86,86,86,86,87,0,37,0,89,90,90,90,90,90,90,91,0,0,0,0,0,0,0,0,0,0,0,56,53,53,53,53,53,53,53,53,53,53,53,53,53,53,53,57,1,1,3,5,11,2,5,4,5,5,5,5,5,5,5,5,12,5,5,1,1,56,53,53,53,53,53,53,53,53,53,53,53
53,53,53,53,53,53,53,53,53,53,53,53,53,57,0,0,0,0,0,0,85,86,86,86,86,86,86,87,0,37,0,89,90,90,90,90,90,90,91,0,0,0,0,0,58,59,0,0,0,0,56,53,53,53,53,53,53,53,53,53,53,53,53,53,53,53,64,59,1,5,2,5,3,5,5,2,10,7,5,5,3,5,2,5,5,1,1,1,56,53,53,53,53,53,53,53,53,53,53,53
53,53,53,53,53,53,53,53,53,53,53,53,62,61,0,0,0,0,0,0,0,0,0,0,0,0,0,0,0,37,0,0,0,0,0,0,0,0,0,0,0,0,0,0,56,57,79,0,0,0,56,53,53,53,53,53,53,53,53,53,53,53,53,53,53,53,53,57,1,1,11,5,7,4,5,5,5,5,5,5,11,5,7,5,5,1,1,1,56,53,53,53,53,53,53,53,53,53,53,53
53,53,53,53,53,53,53,53,53,53,53,53,57,0,0,0,0,23,17,32,36,36,36,36,36,36,36,36,36,44,36,36,36,36,36,36,36,36,36,33,17,17,24,58,65,64,59,0,0,0,56,53,53,53,53,53,53,53,53,53,53,53,53,53,53,53,53,57,1,1,5,5,5,13,5,7,13,3,3,5,5,5,5,5,5,1,1,1,56,53,53,53,53,53,53,53,53,53,53,53
53,53,53,53,53,53,53,53,53,53,53,53,57,0,0,0,0,20,0,0,0,0,0,0,0,0,0,0,71,68,68,68,68,68,68,68,68,72,0,0,0,0,20,56,53,53,57,0,0,0,56,53,53,53,53,53,53,53,53,53,53,53,53,53,53,53,53,57,1,1,1,1,5,3,5,5,5,5,5,7,5,5,5,5,1,1,1,58,65,53,53,53,53,53,53,53,53,53,53,53
53,53,53,53,53,53,53,53,53,53,53,53,57,0,0,0,0,22,0,0,0,71,68,68,68,68,68,68,78,66,66,66,66,66,66,66,66,76,68,72,0,0,20,60,63,62,61,0,0,0,56,53,53,53,53,53,53,53,53,53,53,53,53,53,53,53,53,64,59,3,1,1,5,5,3,5,5,4,5,11,5,2,5,5,1,1,1,56,53,53,53,53,53,53,53,53,53,53,53,53
53,53,53,53,53,53,53,53,53,53,53,53,57,0,0,0,79,0,0,0,0,78,66,66,66,66,66,66,66,66,66,66,66,66,66,66,66,66,66,76,0,0,20,0,56,57,0,79,0,0,56,53,53,53,53,53,53,53,53,53,53,53,53,53,53,53,53,53,57,1,1,1,5,7,5,5,5,5,5,5,5,5,5,5,1,1,3,56,53,53,53,53,53,53,53,53,53,53,53,53
53,53,53,53,53,53,53,53,53,53,53,53,57,0,0,0,0,0,0,0,70,66,66,66,66,66,66,66,66,66,66,66,66,66,66,66,66,66,66,69,0,0,20,0,60,61,0,0,0,0,56,53,53,53,53,53,53,53,53,53,53,53,53,53,53,53,53,53,57,1,1,1,5,5,12,7,5,2,12,5,5,13,5,5,1,1,1,56,53,53,53,53,53,53,53,53,53,53,53,53
53,53,53,53,53,53,53,53,53,53,53,53,57,0,0,0,0,0,0,0,73,66,66,66,66,66,66,66,66,66,66,66,66,66,66,66,66,66,66,69,0,0,22,0,0,0,0,0,0,0,56,53,53,53,53,53,53,53,53,53,53,53,53,53,53,53,53,53,57,1,3,1,1,1,1,5,10,5,2,5,5,5,5,5,1,1,3,56,53,53,53,53,53,53,53,53,53,53,53,53
53,53,53,53,53,53,53,53,53,53,53,53,57,0,0,0,0,0,0,10,0,73,66,66,66,66,66,66,66,66,66,66,66,66,66,66,66,66,74,0,0,0,0,0,0,79,0,0,0,0,56,53,53,53,53,53,53,53,53,53,53,53,53,53,53,53,53,53,64,59,1,1,1,5,1,1,5,5,5,3,5,5,5,1,1,2,1,56,53,53,53,53,53,53,53,53,53,53,53,53
53,53,53,53,53,53,53,53,53,53,53,53,57,0,0,0,0,0,0,0,0,0,73,66,66,66,66,66,66,66,66,66,66,66,66,66,67,74,0,0,0,0,0,0,79,0,0,0,0,58,65,53,53,53,53,53,53,53,53,53,53,53,53,53,53,53,53,53,53,57,1,1,1,1,2,1,1,5,5,5,12,5,3,1,1,1,1,56,53,53,53,53,53,53,53,53,53,53,53,53
53,53,53,53,53,53,53,53,53,53,53,53,64,54,59,0,0,0,0,0,0,0,0,73,67,67,67,67,67,67,67,67,67,67,67,74,0,0,0,0,0,0,0,0,0,0,0,0,58,65,53,53,53,53,53,53,53,53,53,53,53,53,53,53,53,53,53,53,53,64,54,59,3,1,1,1,1,1,1,1,1,5,1,1,3,1,58,65,53,53,53,53,53,53,53,53,53,53,53,53
53,53,53,53,53,53,53,53,53,53,53,53,53,53,57,0,0,0,0,0,0,0,0,0,0,0,0,0,0,0,0,0,0,0,0,0,0,0,0,0,0,0,12,0,0,0,0,58,65,53,53,53,53,53,53,53,53,53,53,53,53,53,53,53,53,53,53,53,53,53,53,64,59,1,1,1,1,1,1,1,1,1,1,1,1,58,65,53,53,53,53,53,53,53,53,53,53,53,53,53
53,53,53,53,53,53,53,53,53,53,53,53,53,53,64,59,0,0,0,0,0,0,0,0,0,0,0,0,0,0,0,0,0,0,0,0,0,0,0,0,0,0,0,0,58,54,54,65,53,53,53,53,53,53,53,53,53,53,53,53,53,53,53,53,53,53,53,53,53,53,53,53,64,54,54,59,1,1,3,1,1,1,58,54,54,65,53,53,53,53,53,53,53,53,53,53,53,53,53,53
53,53,53,53,53,53,53,53,53,53,53,53,53,53,53,64,59,0,0,0,0,0,13,0,0,0,0,0,0,0,0,0,0,0,0,0,0,0,0,0,58,54,54,54,65,53,53,53,53,53,53,53,53,53,53,53,53,53,53,53,53,53,53,53,53,53,53,53,53,53,53,53,53,53,53,64,54,54,54,54,54,54,65,53,53,53,53,53,53,53,53,53,53,53,53,53,53,53,53,53
53,53,53,53,53,53,53,53,53,53,53,53,53,53,53,53,64,59,0,0,0,0,0,0,0,0,0,0,0,0,0,0,0,0,58,54,54,54,54,54,65,53,53,53,53,53,53,53,53,53,53,53,53,53,53,53,53,53,53,53,53,53,53,53,53,53,53,53,53,53,53,53,53,53,53,53,53,53,53,53,53,53,53,53,53,53,53,53,53,53,53,53,53,53,53,53,53,53,53,53
53,53,53,53,53,53,53,53,53,53,53,53,53,53,53,53,53,64,59,0,0,0,0,0,0,0,0,0,0,58,54,54,54,54,65,53,53,53,53,53,53,53,53,53,53,53,53,53,53,53,53,53,53,53,53,53,53,53,53,53,53,53,53,53,53,53,53,53,53,53,53,53,53,53,53,53,53,53,53,53,53,53,53,53,53,53,53,53,53,53,53,53,53,53,53,53,53,53,53,53
53,53,53,53,53,53,53,53,53,53,53,53,53,53,53,53,53,53,64,54,54,54,54,54,54,54,54,54,54,65,53,53,53,53,53,53,53,53,53,53,53,53,53,53,53,53,53,53,53,53,53,53,53,53,53,53,53,53,53,53,53,53,53,53,53,53,53,53,53,53,53,53,53,53,53,53,53,53,53,53,53,53,53,53,53,53,53,53,53,53,53,53,53,53,53,53,53,53,53,53
53,53,53,53,53,53,53,53,53,53,53,53,53,53,53,53,53,53,53,53,53,53,53,53,53,53,53,53,53,53,53,53,53,53,53,53,53,53,53,53,53,53,53,53,53,53,53,53,53,53,53,53,53,53,53,53,53,53,53,53,53,53,53,53,53,53,53,53,53,53,53,53,53,53,53,53,53,53,53,53,53,53,53,53,53,53,53,53,53,53,53,53,53,53,53,53,53,53,53,53
53,53,53,53,53,53,53,53,53,53,53,53,53,53,53,53,53,53,53,53,53,53,53,53,53,53,53,53,53,53,53,53,53,53,53,53,53,53,53,53,53,53,53,53,53,53,53,53,53,53,53,53,53,53,53,53,53,53,53,53,53,53,53,53,53,53,53,53,53,53,53,53,53,53,53,53,53,53,53,53,53,53,53,53,53,53,53,53,53,53,53,53,53,53,53,53,53,53,53,53
53,53,53,53,53,53,53,53,53,53,53,53,53,53,53,53,53,53,53,53,53,53,53,53,53,53,53,53,53,53,53,53,53,53,53,53,53,53,53,53,53,53,53,53,53,53,53,53,53,53,53,53,53,53,53,53,53,53,53,53,53,53,53,53,53,53,53,53,53,53,53,53,53,53,53,53,53,53,53,53,53,53,53,53,53,53,53,53,53,53,53,53,53,53,53,53,53,53,53,53
53,53,53,53,53,53,53,53,53,53,53,53,53,53,53,53,53,53,53,53,53,53,53,53,53,53,53,53,53,53,53,53,53,53,53,53,53,53,53,53,53,53,53,53,53,53,53,53,53,53,53,53,53,53,53,53,53,53,53,53,53,53,53,53,53,53,53,53,53,53,53,53,53,53,53,53,53,53,53,53,53,53,53,53,53,53,53,53,53,53,53,53,53,53,53,53,53,53,53,53
53,53,53,53,53,53,53,53,53,53,53,53,53,53,53,53,53,53,53,53,53,53,53,53,53,53,53,53,53,53,53,53,53,53,53,53,53,53,53,53,53,53,53,53,53,53,53,53,53,53,53,53,53,53,53,53,53,53,53,53,53,53,53,53,53,53,53,53,53,53,53,53,53,53,53,53,53,53,53,53,53,53,53,53,53,53,53,53,53,53,53,53,53,53,53,53,53,53,53,53
53,53,53,53,53,53,53,53,53,53,53,53,53,53,53,53,53,53,53,53,53,53,53,53,53,53,53,53,53,53,53,53,53,53,53,53,53,53,53,53,53,53,53,53,53,53,53,53,53,53,53,53,53,53,53,53,53,53,53,53,53,53,53,53,53,53,53,53,53,53,53,53,53,53,53,53,53,53,53,53,53,53,53,53,53,53,53,53,53,53,53,53,53,53,53,53,53,53,53,53
53,53,53,53,53,53,53,53,53,53,53,53,53,53,53,53,53,53,53,53,53,53,53,53,53,53,53,53,53,53,53,53,53,53,53,53,53,53,53,53,53,53,53,53,53,53,53,53,53,53,53,53,53,53,53,53,53,53,53,53,53,53,53,53,53,53,53,53,53,53,53,53,53,53,53,53,53,53,53,53,53,53,53,53,53,53,53,53,53,53,53,53,53,53,53,53,53,53,53,53
53,53,53,53,53,53,53,53,53,53,53,53,53,53,53,53,53,53,53,53,53,53,53,53,53,53,53,53,53,53,53,53,53,53,53,53,53,53,53,53,53,53,53,53,53,53,53,53,53,53,53,53,53,53,53,53,53,53,53,53,53,53,53,53,53,53,53,53,53,53,53,53,53,53,53,53,53,53,53,53,53,53,53,53,53,53,53,53,53,53,53,53,53,53,53,53,53,53,53,53
53,53,53,53,53,53,53,53,53,53,53,53,53,53,53,53,53,53,53,53,53,53,53,53,53,53,53,53,53,53,53,53,53,53,53,53,53,53,53,53,53,53,53,53,53,53,53,53,53,53,53,53,53,53,53,53,53,53,53,53,53,53,53,53,53,53,53,53,53,53,53,53,53,53,53,53,53,53,53,53,53,53,53,53,53,53,53,53,53,53,53,53,53,53,53,53,53,53,53,53
53,53,53,53,53,53,53,53,53,53,53,53,53,53,53,53,53,53,53,53,53,53,53,53,53,53,53,53,53,53,53,53,53,53,53,53,53,53,53,53,53,53,53,53,53,53,53,53,53,53,53,53,53,53,53,53,53,53,53,53,53,53,53,53,53,53,53,53,53,53,53,53,53,53,53,53,53,53,53,53,53,53,53,53,53,53,53,53,53,53,53,53,53,53,53,53,53,53,53,53
